{
    "groundTextureUrl": "./textures/hospital_floor_texture.jpg",

    "wallTextureUrl": "./textures/hospital_wall_texture.png",
    "size": { "width": 12, "height": 10 },
    "map": [
        [3, 2, 2, 3, 2, 2, 3, 2, 2, 3, 2, 2, 1],
        [1, 0, 0, 1, 0, 0, 1, 0, 0, 1, 0, 0, 1],
        [3, 2, 2, 2, 2, 2, 2, 2, 2, 2, 2, 2, 1],
        [3, 2, 1, 3, 2, 3, 2, 2, 2, 1, 3, 2, 1],
        [1, 0, 1, 1, 0, 1, 0, 0, 0, 1, 1, 0, 1],
        [1, 0, 1, 1, 0, 3, 2, 2, 2, 1, 1, 0, 1],
        [3, 2, 1, 1, 0, 1, 0, 0, 0, 1, 1, 0, 1],
        [1, 0, 1, 2, 2, 2, 2, 2, 2, 0, 2, 2, 1],
        [1, 0, 1, 3, 2, 2, 3, 2, 2, 3, 2, 2, 1],
        [3, 2, 0, 1, 0, 0, 1, 0, 0, 1, 0, 0, 1],
        [2, 2, 2, 2, 2, 2, 2, 2, 2, 2, 2, 2, 0]
    ],
    "initialPosition": [7, 6],
    "initialDirection": 0.0,
    "exitLocation": [-0.5, 6]
}